type octile
height 3
width 1
map
.@
.@
.@